11123532111
33333333333
51111D11115
22222522222
11221112211